0 3 0 0 0 8 8 8 8 0 1 8 8 8 8 1 7 1 5 1
0 0 0 0 0 8 8 8 8 0 1 8 8 8 8 1 1 1 1 1
8 8 0 0 0 8 8 8 8 0 1 8 8 8 8 1 1 1 8 8
8 8 0 0 0 8 8 8 8 0 1 8 8 8 8 1 1 1 8 8
8 8 0 0 0 8 8 8 8 0 1 8 8 8 8 1 1 1 8 8
8 8 0 0 0 0 0 0 0 0 1 1 1 1 1 1 1 1 8 8
8 8 0 2 0 0 0 0 0 0 1 1 1 1 1 1 4 1 8 8
8 8 2 0 0 0 0 0 0 0 1 1 1 1 1 1 1 4 8 8
0 0 0 0 0 0 0 0 0 0 1 1 1 1 1 1 1 1 1 1
0 0 0 0 0 0 0 0 0 0 1 1 1 1 1 1 1 1 1 1
1 1 1 1 1 1 1 1 1 1 0 0 0 0 0 0 0 0 0 0
1 1 1 1 1 1 1 1 1 1 0 0 0 0 0 0 0 0 0 0
8 8 4 1 1 1 1 1 1 1 0 0 0 0 0 0 0 2 8 8
8 8 1 4 1 1 1 1 1 1 0 0 0 0 0 0 2 0 8 8
8 8 1 1 1 1 1 1 1 1 0 0 0 0 0 0 0 0 8 8
8 8 1 1 1 8 8 8 8 1 0 8 8 8 8 0 0 0 8 8
8 8 1 1 1 8 8 8 8 1 0 8 8 8 8 0 0 0 8 8
8 8 1 1 1 8 8 8 8 1 0 8 8 8 8 0 0 0 8 8
1 1 1 1 1 8 8 8 8 1 0 8 8 8 8 0 0 0 0 0
1 5 1 1 1 8 8 8 8 1 0 8 8 8 8 0 6 0 3 0
