0 0 0 0 0 0 0 0 0 0 1 1 1 1 1 1 1 1 1 1
0 0 0 0 0 0 0 0 0 0 1 1 1 1 1 1 1 1 1 1
0 8 8 0 0 0 0 0 0 0 1 1 1 1 1 1 1 8 8 1
0 8 8 0 0 0 0 0 0 0 1 1 1 1 1 1 1 8 8 1
0 0 0 0 0 0 0 0 0 0 1 1 1 1 1 1 1 1 1 1
0 2 0 0 0 8 8 8 8 0 1 8 8 8 8 1 1 1 4 1
0 0 0 0 0 8 8 8 8 0 1 8 8 8 8 1 1 1 1 1
0 0 0 0 0 0 0 0 0 0 1 1 1 1 1 1 1 1 1 1
0 0 0 0 0 0 0 0 0 0 1 1 1 1 1 1 1 1 1 1
0 0 0 0 0 0 0 0 0 0 1 1 1 1 1 1 1 1 1 1
1 1 1 1 1 1 1 1 1 1 0 0 0 0 0 0 0 0 0 0
1 1 1 1 1 1 1 1 1 1 0 0 0 0 0 0 0 0 0 0
4 1 1 1 8 8 5 4 1 1 0 0 2 3 8 8 0 0 0 2
1 8 8 1 8 8 1 1 1 1 0 0 0 0 8 8 0 8 8 0
1 8 8 1 8 8 1 1 1 1 0 0 0 0 8 8 0 8 8 0
7 8 8 1 8 8 1 1 1 1 0 0 0 0 8 8 0 8 8 6
1 8 8 1 8 8 8 8 8 8 8 8 8 8 8 8 0 8 8 0
5 8 8 1 8 8 8 8 8 8 8 8 8 8 8 8 0 8 8 3
1 8 8 1 1 4 1 1 1 1 0 0 0 0 2 0 0 8 8 0
1 1 1 1 1 1 1 1 1 1 0 0 0 0 0 0 0 0 0 0
